Xiaobo Cui	admin
Zetao Bai	baizetao
Xiaohui Cheng	chengxiaohui
Kunrong Chen	chenkunrong
Zhixue Dong	dongzhixue
Juping Fang	fangjuping
Xiaoping Fang	fangxiaoping
Tongyu Fu	futongyu
Feng Gao	gaofeng
Rafaqat Ali Gill	gill
Yizhou He	heyizhou
Jiachang Hou	houjiachang
Junyan Huang	huangjunyan
Ming Hu	huming
Qinglin Ke	keqinglin
Fan Liu	liufan
Jie Liu	liujie
Lijiang Liu	liulijiang
Shengyi Liu	liushengyi
Yueying Liu	liuyueying
Xiaomin Li	lixiaomin
Li Qin	qinli
Li Ren	renli
Cuicui Shen	shencuicui
Chaobo Tong	tongchaobo
Zengfeng Wang	wangzengfeng
Yupo Wu	wuyupo
Meili Xie	xiemeili
Li Xu	xuli
Li Yang	yangli
Lingli Yang	yanglingli
Lingyi Zeng	zenglingyi
Xiong Zhang	zhangxiong
Yi Zhang	zhangyi
Yuanyuan Zhang	zhangyuanyuan
Zeyu Zhang	zhangzeyu
Chuanji Zhao	zhaochuanji
Cong Zhou	zhoucong
Rong Zuo	zuorong